<width>
50
<height>
50

3 3 3 3 3 3 3 3 3 3 3 3 3 3 3 3 3 3 3 3 3 3 3 3 3 3 3 3 3 3 3 3 3 3 3 3 3 3 3 3 3 3 3 3 3 3 3 3 3 3 
3 3 3 3 3 3 3 3 3 3 3 3 3 3 3 3 3 3 3 3 3 3 3 3 3 3 3 3 3 3 3 3 3 3 3 3 3 3 3 3 3 3 3 3 3 3 3 3 3 3 
3 3 3 3 3 3 3 3 3 3 3 3 3 3 3 3 3 3 3 3 3 3 3 3 3 3 3 3 3 3 3 3 3 3 3 3 3 3 3 3 3 3 3 3 3 3 3 3 3 3 
3 3 3 3 3 3 3 3 3 3 3 3 3 3 3 3 3 3 3 3 3 3 3 3 3 3 3 3 3 3 3 3 3 3 3 3 3 3 2 2 2 2 2 2 2 2 3 3 3 3 
3 3 3 3 3 3 3 3 4 4 4 4 3 3 3 3 3 3 3 3 3 3 3 3 3 3 3 3 3 3 3 3 3 3 3 3 3 3 2 3 3 3 3 3 3 2 3 3 3 3 
3 3 3 3 3 3 4 4 4 3 3 3 4 4 4 3 3 3 3 3 3 3 3 3 3 3 3 3 3 3 3 3 3 3 3 3 3 3 2 3 3 3 3 3 3 2 3 3 3 3 
3 3 3 3 3 4 4 3 3 3 3 3 3 3 4 4 4 4 3 3 3 3 3 3 3 3 3 3 3 3 3 3 3 3 3 3 3 3 2 3 3 3 3 3 3 2 3 3 3 3 
3 3 3 3 3 4 3 3 3 3 3 3 3 3 3 3 3 3 4 4 4 4 4 4 3 3 3 3 3 3 3 3 3 3 3 3 3 3 2 3 3 3 3 3 3 2 3 3 3 3 
3 3 3 3 3 4 3 3 3 3 3 3 3 3 3 3 3 3 3 3 3 3 3 3 4 4 4 4 4 3 3 3 3 3 3 3 3 3 2 3 3 3 3 3 3 2 3 3 3 3 
3 3 3 3 3 4 3 3 3 3 3 3 3 3 3 3 3 3 3 3 3 3 3 3 3 3 3 3 4 4 4 3 3 3 3 3 3 3 2 2 2 3 2 2 2 2 3 3 3 3 
3 3 3 3 3 4 3 3 3 3 3 3 3 3 3 3 3 3 3 3 3 3 3 3 3 3 3 3 3 3 4 4 3 3 3 3 3 3 3 3 3 3 3 3 3 3 3 3 3 3 
3 3 3 3 3 4 4 3 3 3 3 3 3 3 3 3 3 3 3 3 3 3 3 3 3 3 3 3 3 3 3 3 4 4 3 3 3 3 3 3 3 3 3 3 3 3 3 3 3 3 
3 3 3 3 3 3 4 3 3 3 3 3 3 3 3 3 3 3 3 3 3 3 3 3 3 3 3 3 3 3 3 3 3 4 4 3 3 3 3 3 3 3 3 3 3 3 3 3 3 3 
3 3 3 3 3 3 3 4 4 3 3 3 3 3 3 3 3 3 3 3 3 3 3 3 3 3 3 3 3 3 3 3 3 3 4 4 3 3 3 3 3 3 3 3 3 3 3 3 3 3 
3 3 3 3 3 3 3 3 4 3 3 3 3 3 3 3 3 3 3 3 3 3 3 3 3 3 3 3 3 3 3 3 3 3 3 4 3 3 3 3 3 129 129 129 129 3 3 3 3 3 
3 3 3 3 3 3 3 3 4 3 3 3 3 3 3 3 3 3 3 3 129 129 129 129 129 3 3 3 3 3 3 3 3 3 3 4 3 3 3 3 3 129 129 129 129 3 3 3 3 3 
3 3 3 3 3 3 3 4 4 3 3 3 3 3 3 3 3 129 129 129 129 129 129 129 129 129 129 3 3 3 3 3 3 3 3 4 3 3 3 3 3 129 129 129 129 3 3 3 3 3 
3 3 3 3 3 3 4 4 3 3 3 3 3 3 3 3 3 129 129 129 129 129 129 129 129 129 129 129 129 3 3 3 3 3 3 4 4 3 3 3 3 129 129 129 129 3 3 3 3 3 
3 3 3 3 3 3 4 3 3 3 3 3 3 3 3 3 3 129 129 129 129 129 129 129 129 129 129 129 129 129 3 3 3 3 3 3 4 3 3 3 3 129 129 129 129 3 3 3 3 3 
3 3 3 3 3 4 3 3 3 3 3 3 3 3 3 3 3 129 129 129 129 129 129 129 129 129 129 129 129 129 129 3 3 3 3 3 4 4 3 3 3 3 3 3 3 3 3 3 3 3 
3 3 3 3 4 4 3 3 3 3 3 3 3 3 3 3 3 129 129 129 129 129 129 129 129 129 129 129 129 129 129 3 3 3 3 3 3 4 4 3 3 3 3 3 3 3 3 3 3 3 
3 3 3 3 4 3 3 3 3 3 3 3 3 3 3 3 3 129 129 129 129 129 129 129 129 129 129 129 129 129 129 129 3 3 3 3 3 3 4 4 3 3 3 3 3 3 3 3 3 3 
3 3 3 3 4 3 3 3 3 3 3 3 3 3 3 3 3 129 129 129 129 129 129 129 129 129 129 129 129 129 129 129 3 3 3 3 3 3 3 3 4 3 3 3 3 3 3 3 3 3 
3 3 3 3 4 4 3 3 3 3 3 3 3 3 3 3 3 129 129 129 129 129 129 129 129 129 129 129 129 129 129 129 129 3 3 3 3 3 3 3 3 4 4 3 3 3 3 3 3 3 
3 3 3 3 3 4 4 3 3 3 3 3 3 3 3 3 3 3 129 129 129 129 129 129 129 129 129 129 129 129 129 129 129 3 3 3 3 3 3 3 3 3 4 4 3 3 3 3 3 3 
3 3 3 3 3 3 3 4 4 3 3 3 3 3 3 3 3 3 3 129 129 129 129 129 129 129 129 129 129 129 129 129 129 129 3 3 3 3 3 3 3 3 3 4 3 3 3 3 3 3 
3 3 3 3 3 3 3 3 4 4 3 3 3 3 3 3 3 3 3 129 129 129 129 129 129 129 129 129 129 129 129 129 129 129 3 3 3 3 3 3 3 3 3 4 3 3 3 3 3 3 
3 3 3 3 3 3 3 3 3 4 4 3 3 3 3 3 3 3 3 129 129 129 129 129 129 129 129 129 129 129 129 129 129 129 3 3 3 3 3 3 3 3 3 4 3 3 3 3 3 3 
3 3 3 3 3 3 3 3 3 3 4 4 3 3 3 3 3 3 3 129 129 129 129 129 129 129 129 129 129 129 129 129 129 129 129 3 3 3 3 3 3 3 3 4 3 3 3 3 3 3 
3 3 3 3 3 3 3 3 3 3 3 4 4 3 3 3 3 3 3 129 129 129 129 129 129 129 129 129 129 129 129 129 129 129 129 3 3 3 3 3 3 3 3 4 3 3 3 3 3 3 
3 3 3 3 3 3 3 3 3 3 3 3 3 4 4 3 3 3 3 129 129 129 129 129 129 129 129 129 129 129 129 129 129 129 129 3 3 3 3 3 3 3 3 4 3 3 3 3 3 3 
3 3 3 3 3 3 3 3 3 3 3 3 3 3 4 3 3 3 3 129 129 129 129 129 129 129 129 129 129 129 129 129 129 129 129 3 3 3 3 3 3 3 3 4 3 3 3 3 3 3 
3 3 3 3 3 3 3 3 3 3 3 3 3 3 4 3 3 3 3 129 129 129 129 129 129 129 129 129 129 129 129 129 129 129 129 3 3 3 3 3 3 3 3 4 3 3 3 3 3 3 
3 3 3 3 3 3 3 3 3 3 3 3 3 3 4 3 3 3 3 129 129 129 129 129 129 129 129 129 129 129 129 129 129 129 129 3 3 3 3 3 3 3 3 4 3 3 3 3 3 3 
3 3 3 3 3 3 3 3 3 3 3 3 3 4 3 3 3 3 3 129 129 129 129 129 129 129 129 129 129 129 129 129 129 129 129 3 3 3 3 3 3 3 3 4 3 3 3 3 3 3 
3 3 3 3 3 3 3 3 3 3 3 3 3 4 3 3 3 3 3 3 129 129 129 129 129 129 129 129 129 129 129 129 129 129 3 3 3 3 3 3 3 3 3 4 3 3 3 3 3 3 
3 3 3 3 3 3 3 3 3 3 3 3 4 3 3 3 3 3 3 3 3 3 129 129 129 129 129 129 129 129 129 129 129 3 3 3 3 3 3 3 3 3 3 4 3 3 3 3 3 3 
3 3 3 3 3 3 3 3 3 3 3 4 3 3 3 3 3 3 3 3 3 3 3 3 129 129 129 129 129 129 129 3 3 3 3 3 3 3 3 3 3 3 4 4 3 3 3 3 3 3 
3 3 3 3 3 3 3 3 3 3 4 4 3 3 3 3 3 3 3 3 3 3 3 3 3 3 3 3 3 3 3 3 3 3 3 3 3 3 3 3 3 3 4 3 3 3 3 3 3 3 
3 3 3 3 3 3 3 3 3 3 4 3 3 3 3 3 3 3 3 3 3 3 3 3 3 3 3 3 3 3 3 3 3 3 3 3 4 4 4 3 3 4 4 3 3 3 3 3 3 3 
3 3 3 3 3 3 3 3 3 3 4 3 3 3 3 3 3 3 3 3 3 3 3 3 3 3 3 3 3 3 3 3 3 3 3 4 4 3 4 4 4 4 3 3 3 3 3 3 3 3 
3 3 3 3 3 3 3 3 3 4 4 3 3 3 3 3 3 3 3 3 3 3 3 3 3 3 3 3 3 3 3 3 3 4 4 3 3 3 3 3 3 3 3 3 3 3 3 3 3 3 
3 3 3 3 3 3 3 3 3 4 3 3 3 3 3 3 3 3 3 3 3 3 3 3 3 3 3 3 3 3 4 4 4 3 3 3 3 3 3 3 3 3 3 3 3 3 3 3 3 3 
3 3 3 3 3 3 3 3 3 4 3 3 3 3 3 3 3 3 3 3 3 3 3 3 3 3 3 3 4 4 4 3 3 3 3 3 3 3 3 3 3 3 3 3 3 3 3 3 3 3 
3 3 3 3 3 3 3 3 3 4 3 3 3 3 3 3 3 3 3 3 3 3 3 3 3 3 4 4 4 3 3 3 3 3 3 3 3 3 3 3 3 3 3 3 3 3 3 3 3 3 
3 3 3 3 3 3 3 3 3 4 4 3 3 3 3 3 3 3 3 3 3 3 3 4 4 4 4 3 3 3 3 3 3 3 3 3 3 3 3 3 3 3 3 3 3 3 3 3 3 3 
3 3 3 3 3 3 3 3 3 3 4 4 4 4 4 4 4 4 4 4 4 4 4 4 3 3 3 3 3 3 3 3 3 3 3 3 3 3 3 3 3 3 3 3 3 3 3 3 3 3 
3 3 3 3 3 3 3 3 3 3 3 3 3 3 3 3 3 3 3 3 3 3 3 3 3 3 3 3 3 3 3 3 3 3 3 3 3 3 3 3 3 3 3 3 3 3 3 3 3 3 
3 3 3 3 3 3 3 3 3 3 3 3 3 3 3 3 3 3 3 3 3 3 3 3 3 3 3 3 3 3 3 3 3 3 3 3 3 3 3 3 3 3 3 3 3 3 3 3 3 3 
3 3 3 3 3 3 3 3 3 3 3 3 3 3 3 3 3 3 3 3 3 3 3 3 3 3 3 3 3 3 3 3 3 3 3 3 3 3 3 3 3 3 3 3 3 3 3 3 3 3

